222222222222222222222222222222222222222222222222222222222221
100000000440000004400000040004000040004000004000040000000401
100000000440000004400000040004000040004000004000040000000401
100000000440000004400000040004000040004000004000040000000401
100000000440000004400000040004000040004000004000040000000401
100000000440000004400000040004000040004000004000040000000401
100000000440000033330000040004000040004000004000040000000401
100000002222000003330000333333300040004000004000333333333331
100000000220000000000000333333355655556665555555333333333331
100000000000000000000000333333300000000000000000333333333331
100000000000000000000000333333355666555555666555333333333331
100000000000000000000000333333300000000000000000333333333331
100000000000000000000000000000000000000000000000000022222221
100000000000000000000000000000000000000000000000000000002221
100000000000000000000000000000000000000000000000000000000001
100000000000000000000000000000000000000000000000000000000001
100000000000000000000000000000000000000000000000000000000001
100000000000000000000000000000000000000000000000000000000001
100000000000000000000000000000000000000000000000000000000001
100000000000000000000000000000000000000000000000000000000001
100000000000000000000000000000000000000000000000000000000001
100000000000000000000000000000000000000000000000000000000001
100000000000000000000000000000000000000000000000000000000001
100000000000000000000000000000000000000000000000000000000001
100000000000000000000000000000000000000000000000000000000001
100000000000000000000000000000000000000000000000000000000001
100000000000000000000000000000000000000000000000000000000001
100000000000000000000000000000000000000000000000000000000001
100000000000000000000000000000000000000000000000000000000001
100000000000000000000000000000000000000000000000000000000001
100000000000000000000000000000000000000000000000000000000001
100000000000000000000000000333000000000000333000000000000001
100000000000000000000000033333300000000003333300000000000001
222222222222222222222222222222222222222222222222222222222222