122222222222222222222222222222222222222222222222222222222221
100000000440000004404000040004000040004000004000040000000401
100000000440000004404000040004000040004000004000040000000401
100000000440000004404000040004000040004000004000040000000401
100000000440000004404000040004000040004000004000040000000401
100000000440000004404000040004000040004000004000040000000401
100000000440000031131300040004000040004000004000040000000401
100000002222000003223000313331300040004000004000323333333231
100000000220000000330000333333355625562662552555333333333331
100000000000000000000000333333300000000000000000333333333331
100000000000000000000000333333355666555555666555333333333331
100000000000000000000000333333300000000000000000333333333331
100000000000000000000000400000400000000000000000000022222221
100000000000000000000000400000400000000000000000000000022221
100000000000000000000000400000400000000000000000000000000001
100000000000000000000000211111200000000000000000000000000001
100000000000000000000000000000000000000000000000000000000001
100000000000000000000000000000000000000000000000000000000001
100000000000000000000000000000000000000000000000000000000001
100000000000000000000000000000000000000000000000000000000001
100000000000000000000000000000000000000000000000000000000001
100000000000000000000000000000000000000000000000000000000001
100000000000000000000000000000000000000000000000000000000001
100000000000000000000000000000000000000000000000000000000001
100000000000000000000000000000000000000000000000000000000001
100000000000000000000000000000000000000000000000000000000001
100000000000000000000000000000000000000000000000000000000001
100000000000000000000000000000000000000000000000000000000001
100000000000000000000000000000000000000000000000000000000001
100000000000000000000000000000000000000000000000000000000001
100000000000000000000000000000000000000000000000000000000001
100000000000000000000000000333000000000000333000000000000001
100000000000000000000000033333300000000003333300000000000001
222222222222222222222222222222222222222222222222222222222222
