11111111111111111111111111111111111111111111111111111111111
00000000000000000000000000000000000000000000000000000000001
00000000000000000000000000000000000000000000000000000000001
00000000000000000000000000000000000000000000000000000000001
00000000000000000000000000000000000000000000000000000000001
00000000000000000000000000000000000000000000000000000000001
00000000000000000000000000000000000000000000000000000000001
00000000000000000000000000000000000000000000000000000000001
00000000000000000000000000000000000000000000000000000000001
00000000000000000000000000000000000000000000000000000000001
00000000000000000000000000000000000000000000000000000000001
00000000000000000000000000000000000000000000000000000000001
00000000000000000000000000000000000000000000000000000000001
00000000000000000000000000000000000000000000000000000000001
00000000000000000000000000000000000000000000000000000000001
00000000000000000000000000000000000000000000000000000000001
00000000000000000000000000000000000000000000000000000000001
00000000000000000000000000000000000000000000000000000000001
00000000000000000000000000000000000000000000000000000000001
00000000000000000000000000000000000000000000000000000000001
00000000000000000000000000000000000000000000000000000000001
00000000000000000000000000000000000000000000000000000000001
00000000000000000000000000000000000000000000000000000000001
00000000000000000000000000000000000000000000000000000000001
00000000000001111000000000000000000000000000000000000000001
00000000000000000000000000000000000000000000000000000000001
00000000000000000000000000000000000000000000000000000000001
00000000000000000000000000000000000000000000000000000000001
00000000000000000000000000000000000000011110000000000000001
00000000000000000000000000000000000000000000000000000000001
00000000000000000000000000000000000000000000000000000000001
00000000000000000000000000000000000000000000000000000000001
11111111111111111111111111111111111111111111111111111111111