111111111111111111111111111111111111111111111111111111111111
100400000000040000000000004000000000000000004000000040000001
100400000000040000000000004000000000000000004000000040000001
100400000000040000000000004000000000000000004000000030000001
100400000000040000000000003000000000000000004000000000000001
100400000000040000000000000000000000000000004000000000000001
100300000000040000000000000000000000000000003000000000000001
100000000000030000000000000000000000000000000000000000000001
100000000000000000000000000000000000000000000000000000000001
100000000000000000000000000000000000000000000000000000000001
155555566555555566666555556665555665555555555666665555555551
100000000000040000400040004040004000000000000000000000000001
100000000000040000400040004040004000000000000000000000000001
100000000000040000400040004040004000000000000000000000000001
100000000000040000400040004040004000000000000000000000000001
100000000000040000400040004040004000000000000000000000000001
100000000000040000400040004040000000000000000000000000000001
100000000000040000400040004040000000000000000000000000000001
100000000000040000400040004040004000000000000000000000000001
100000000000040000400012221040004000000000000000000000000001
100000000000040000400000000040004000000000000000000000000001
100000000000040000400000000040004000000000000000000000000001
100000000000040000400000000040004000000000000000000000000001
100000000000040000400000000040004000000000000000000000000001
100000000000032222300000000040004000000000000000000000000001
100000000000000000000000000040004000001110000000000000000001
100000000000000000000000000011111000000000000000000000000001
100000000000000000000000000000000000000000000000000000000001
100000000000000000000000000000000000000000000000000000000001
100000000000000000000000000000000000000022220000000000000001
100000000000000000000000000000000000000000000000000000000001
100000000000000000000000000000000000000000000000000000000001
100000000000000000000000000000000000000000000000000000070071
111111111111111111111111111111111111111111111111111111111111
